ENGLESKI

clue - trag
intent - namera
regarding to - u vezi sa
spot mistakes - uociti greske
devastating - porazavajuce
convey information - preneti informacije
if it meets that criteria - ako zadovoljava taj kriterijum
distinguish - razlikovati
glance at - pogled na
novelty - novina
little grain of salt - malo zrna soli
at a glance - na prvi pogled
revise that somehow - revidirati to nekako
measures - mere
inference - zakljucivanje
(making that inference for you - umesto tebe da to zakljuci)
overlap - preklapanje
regardless of if there is a match at all - nebitno da li ima para
revamp - prepraviti (we're gona completely revamp this at the end)
gauge (gejdz) - merac (u power BI imam onako kao na skali prikaz)

little bit odd - malo cudno
to determine that - da se to utvrdi
folks - narod,ljudi
absence of a value - odsustvo vrednosti
doesn't impact - ne utice
this can be a little DECEIVING(desiving) - ovo moze biti malo obmanjujuce
utilize - iskoristiti
establish - uspostaviti, utvrditi
trade offs - kompromisi
comprehend - shvatiti (understand) ; we cant clearly comprehend until we visualize this
at a glance - na prvi pogled
stemming from outdated systems - proisticu iz zastarelih sistema
reliant on excel - zasnovanih na excelu

Seeking to centralize operations and enhance efficiency, they sought our expertise to implement tailored Microsoft Dynamics 365 solutions. - У жељи да централизују операције и побољшају ефикасност, тражили су нашу стручност за имплементацију прилагођених Мицрософт Динамицс 365 решења.

to unify - da objedinimo

provide - obezbediti

Utilizing Microsoft Dynamics 365 alongside Power Apps - koristeci md uz pa

we engineered - osmislili smo
comprehensive - sveobuhvatno
tailored to their needs - prilagodjeno njihovim potrebama
cumbersome - glomazno
streamlined platform - modernizovana platforma
sales pipeline - prodajni kanal
enhancing efficiency - poboljsavajuci efikasnost

keen eye for detail, tireless effort (neumorni trud)
contribute to - doprinose
positivity you infuse (infjuz) - pozitiva koju ulivas,unosis
accomplish - postici


cappable of - biti sposoban
more engaging and fulfilling work - angazovaniji i ispunjeniji posao
embrace - zagrliti, prigrliti (embrace personal growth)
turnaround times - vreme obrade (quicker turnaround times)
ensures adherence - osigurava pridrzavanje
unattended - bez nadzora
Mortgage appraisals - procene hipoteke
likewis - isto tako (lajkvas)
hence the name - otuda i naziv (hens d nejm)
irrespective - bez obzira na to
more comprehensive - sveobuhvatnije
clue - trag
delve into - udubiti se u